1111111111111
1P000E0000C01
1111111111111