1111111111111111
1P000C00000E0101
1111111111111111