1111111111111111
1P000C0000E01001
1111111111111111